###########################################################################
#                                                                         #
#           .............................                             .   #
#                                                                     .   #
#                                                                     .   #
#                      ..............                                 .   #
#                                                                     .   #
#                                                                     .   #
#   .                                                                 .   #
#   .                                                                 .   #
#   .                                                                 .   #
#   .                               ........................              #
#   .                                                                     #
#   ........                                                              #
#                                                                         #
###########################################################################